           #
   #  #    #
   #  #    #
#  #  #  # #
           #
           #
#  #  #  # #
   #  #    #
#  #  #    #
