...#######################
......#..#...............#
####..#..#..####...####..#
#.....................#..#
#.....................#..#
####..#..#..####...#..#..#
#..#..#..#..#.........#..#
#..#..#..#..#.........#..#
#.................#####..#
#........................#
#..###....###..#.........#
#..#........#..#.........#
#.................#####..#
#.....####...............#
#........................#
#........................#
##########################