...........#....
...#..#.........
...#..#.........
#..#..#..#.#####
................
................            
#..#..#..#.#####
...#..#.....#...
.#..#.....#....#
#...............
##########..####